ab = abkhazo
aa = lontano
af = afrikaans
ak = Akan
sq = albanese
am = amarico
ar = arabo
an = aragonese
hy = armeno
come = Assamese
av = Avarico
ae = Avestan
ay = Aymara
az = azero
bm = Bambara
ba = Bashkir
eu = basco
be = bielorusso
bn = bengalese
bh = lingue Bihari
bi = Bislama
bs = bosniaco
br = bretone
bg = bulgaro
my = birmano
ca = catalano, valenciano
ch = Chamorro
ce = ceceno
ny = Chichewa, Chewa, Nyanja
zh = cinese
cv = Ciuvascia
kw = Cornovaglia
co = corso
cr = Cree
hr = croato
cs = ceco
da = danese
dv = Divehi, Dhivehi, Maldiviano
nl = olandese, fiammingo
dz = Dzongkha
en = inglese
eo = Esperanto
et = estone
ee = pecora
fo = faroese
fj = Fijian
fi = finlandese
fr = francese
ff = Fulah
gl = galiziano
ka = georgiano
de = tedesco
el = greco, moderno
gn = Guarani
gu = Gujarati
ht = haitiano, creolo haitiano
ha = Hausa
he = ebraico
hz = Herero
ciao = hindi
ho = Hiri Motu
hu = ungherese
ia = Interlingua (International Auxiliary Language Association)
id = indonesiano
ie = Interlingue, Occidental
ga = irlandese
ig = Igbo
ik = Inupiaq
io = Ido
è = islandese
it = italiano
iu = Inuktitut
ja = giapponese
jv = giavanese
kl = Kalaallisut, groenlandese
kn = Kannada
kr = Kanuri
ks = Kashmiri
kk = kazako
km = Khmer centrale
ki = Kikuyu, Gikuyu
rw = Kinyarwanda
ky = kirghiso, kirghiso
kv = Komi
kg = Kongo
ko = coreano
ku = curdo
kj = Kuanyama, Kwanyama
la = latino
lb = lussemburghese, Letzeburgesch
lg = Ganda
li = Limburgan, Limburger, Limburgish
ln = lingala
lo = Lao
lt = lituano
lu = Luba-Katanga
lv = lettone
gv = Manx
mk = macedone
mg = malgascio
ms = malese
ml = Malayalam
mt = maltese
mi = Maori
mr = Marathi
mh = marshallese
mn = mongolo
na = Nauru
nv = Navajo, Navaho
nd = North Ndebele
ne = nepalese
ng = Ndonga
nb = norvegese Bokmål
nn = norvegese Nynorsk
no = norvegese
ii = Sichuan Yi, Nuosu
nr = South Ndebele
oc = occitano
oj = Ojibwa
cu = slavo ecclesiastico, antico slavo, slavo ecclesiastico, antico bulgaro
om = Oromo
o = Oriya
os = osseto, osseto
pa = Punjabi, Panjabi
pi = Pali
fa = persiano
pl = polacco
ps = Pashto, Pushto
pt = portoghese
qu = Quechua
rm = romancio
rn = Rundi
ro = rumeno, moldavo, moldavo
ru = russo
sa = sanscrito
sc = sardo
sd = Sindhi
se = Sami settentrionale
sm = samoano
sg = Sango
sr = serbo
gd = gaelico, gaelico scozzese
sn = Shona
si = singalese, singalese
sk = slovacco
sl = sloveno
quindi = somalo
st = Sotho meridionale
es = spagnolo, castigliano
su = Sundanese
sw = swahili
ss = Swati
sv = svedese
ta = Tamil
te = Telugu
tg = tagico
th = tailandese
ti = Tigrinya
bo = tibetano
tk = turkmeno
tl = tagalog
tn = Tswana
a = Tonga
tr = turco
ts = Tsonga
tt = tataro
tw = Twi
ty = tahitiano
ug = uigura, uigura
uk = ucraino
ur = urdu
uz = uzbeko
ve = Venda
vi = vietnamita
vo = Volapük
wa = vallone
cy = gallese
wo = wolof
fy = Frisone occidentale
xh = Xhosa
yi = yiddish
yo = Yoruba
za = Zhuang, Chuang
zu = Zulu